................
.....1....GXG...
..G#.....$@@@...
.P.#..........G.
.@##.........G#.
.@#@.........@..
.@@.............
...........GC.P.
...G.......####$
..G.a...Gb......
.$###$.$##......
..###$.$##......
