................
................
.X..GCG...d..G..
.##.@@@#..#.G#..
...........G#..G
..........G#...@
..#G.....G#....@
..##....$#.....@
...G.G...#......
..P.G.A..#G..1b.
.$#####$.######$
..#####$.######.
