................
.............X..
.....PA......@@$
.....###........
...........c....
..b.......@@...G
.@@@..........@@
................
......G..D.G.G.G
..1..G.G@##.G.G.
.##$.###########
.##$.###########
