................
................
.X...........G.G
.###..........G.
.............###
..P..b....G.G...
..@####$...G....
..........@@@...
.....G.G.G.G....
..C.G.G.G.G.G.1.
.$#############$
..#############.
