................
............1G..
...........$###@
................
................
..............G.
..............@@
................
..............G.
..X..........P.P
.$#$........$###
..#$........$##.
