................
...1......G..X..
.........##..##$
........G##..##$
.......@@.......
......G@@.......
.....@@.........
....G@@.........
...@@.....G.G.G.
.Ga@@...dG.G.G.G
.##....$########
..#...$########.
