................
....G##......1..
.Pb##........###
.@#.......$@....
.......$........
....G##....a..G.
.G.@@......##G.G
.@@.........##@#
................
..X..........G..
.$##d.......G.G.
..#####$$$$####$
