................
.............#..
.P.G.........#1.
..G.A...c....##$
.####...@@......
.......@@.......
......@@........
.............G..
.....G.G...DG.P.
..XcG.G...G####$
.$######..#####$
.#######..#####.
