................
.#############..
.###############
.##...........##
.#.............#
.#.......G.....#
.#...P...##....#
.#...##.$$#G...#
.#...##.$$##G..#
.#Xa.##.$$###G1#
.###$##.$$######
..##$##.$$#####.
