................
.P.G....G.G.....
.@@@G...###.d..X
..@@@G....##@@##
....@@..........
................
..PA.......@@$..
.@####$.........
..G..G.......G.P
.G..1.G....BG.G.
.######....#####
..#####$..$####.
