................
....G.G.#..@@#1.
..AG.G.G#G.G.#..
..#@@####.G.G#..
....@@####@@#@..
.....@@##....@..
......@@#..G.@..
........#..@@@..
........#P.G.G..
.d..b..X#CG.G.G.
.####$$########$
..###$$########.
