................
................
.G...G..G..G....
.@@....G..G.D.X.
....###########$
................
..G.............
.@@.............
.....G..G..G....
.G....aG.Gb...1.
.##..#######.G#$
..#$########$##.
