....G#.....#G...
....@#.....@@...
....@.....#@@G..
....@.....#.#@#$
....@#$...#.#@..
....##....#.$...
....##...D#.....
...a##@@@@#.G.Xc
..####....P.####
.1####..BP.P####
.###############
..#############.
