................
.##1.@#####@@G..
.#...$......#@@P
.#............@@
.#....G........#
..$..G##.......#
.....@.#..$#...#
.b.....#..$#...#
.#.....#..$#...#
.#..GCP#..$#.AX#
.#G@@@@#..$#@@@#
..######..$####.
