....G#.....#G...
....@#....G@@...
....@.....#.@G..
....@.....#.##$.
....@#$...#.#...
....#.G.G.#.#...
....#G.G.C#.#...
...a##@@@@#.#Xd.
..##@....P.P###$
.1##@...B.P.####
.###############
..#############.
