................
...1........G...
............@@..
.........G..@@..
.........@@.....
.........@@.....
.......G........
.......@@.......
.......@@.......
..G..G......PaXd
.$#$$#.....$####
..#$$#.....$###.
