................
..G......G..XG..
..#......#..@@@.
..#1.....#G.....
..##G.....#.....
...##..G..#G..G.
...@@..@@.##..@@
....@@....##G...
...G.#.....##..G
.bG.P#G.C.G##.G.
.############$##
..###########$#.
