............#...
..1.........#X..
...#........##@#
...#.G..G....#@@
...#P.GC.....#@@
....@#@@#$....#@
...........d..@@
...........#..@@
......G...$...##
.G..@G.GA.#...##
.@$.#######..$##
..$.#######..##.
