................
............#...
..P.........#.1.
...Ga...G...$##.
..###$.c@@......
.......@@.......
................
.............G..
.....G.G...BG.P.
..XDG.G...G####$
.$######..#####$
..######..#####.
