................
.1..G..#D.G.....
...G...####...GX
...@@G.......G@@
.....@......@@..
................
..Ga....a.....c.
.$##...G@$...G@$
.$##...##$...##$
.$##...##$..G##$
.$##...##$..###$
..##...##$..###.
