................
............a...
...........d#@..
..........@@...P
......b..$....##
.....##.........
....$...@....G..
.............##G
.1G.........G###
.@@G....X..G####
.###...$#.$@####
..##...$#.$####.
