................
.P...........X..
.@@$...$#....###
........#G...###
........##...###
.G..G...##G..@$#
..Gb.#..###.G@$#
.####...###@@@$#
.###............
.###..a..c..d.1.
.######$$######$
..#####$$######.
