................
....G...G....G..
.X.G.GBG.G#..@@.
.##########.....
................
..............G.
..............@@
................
....G...........
.1.G.G.......G..
.#####P.....$##$
..#####....$###.
