....G...........
.P.G.G.G...G....
.######@...@$...
................
..G.G.G.........
.P.G.G.G.#......
.######@..$..@$.
................
..G.G...........
.X.G.G....GA..1.
.#####$$.@@@@.#$
..@@@@@$......#.
