................
................
.P.G.G..G.G.G...
..G.G....G.G....
.###@@..###@@...
................
............G...
............@@..
................
..Xd......B.....
.$###$$.@@@@@@1.
.####$$.########
