................
..G.............
.G.G1......d..X.
.###..G.B..@@###
.###..@@@.....##
.###............
.###G.....@@....
.####...........
.####G...G.G.G..
.#####GC..G.G.P.
.##############$
..#############.
