................
................
......@.........
.###......####-.
..........####-.
................
................
................
................
..1...........X.
.###############
.###############
