................
................
......@.........
.#........####..
................
................
................
................
................
..1...........X.
.###############
.###############
