................
................
......@.........
.#........####-.
..........##....
................
................
................
................
..1...........X.
.###############
.###############
