................
................
......@.........
.####.....####-.
..........###...
................
................
................
................
..1...........X.
.###############
.###############
