................
................
......@.........
.###......####-.
..........#.....
................
................
................
................
..1...........X.
.###############
.###############
